EnvBioelement-fam	EnvBioelement-category	microtrait-hmm-name
arsC	arsenic	arsC
glutathione-glutaredoxin_type	arsenic	arsC2
thioredoxin	arsenic	arsC2
arsenite_oxidase_large	arsenic	aoxB
arsenite_oxidase_small	arsenic	aoxA
fae	C1Compounds	fae-hps
fdh_thiol-independent_type	C1Compounds	fdhA
formylmethanofuran-tetrahyromethanopterin_formyltransferase	C1Compounds	ftr
methenyltetrahydromethanopterin_cyclohydrolase	C1Compounds	mtdch
S--hydroxymethyl-glutathione_dehydrogenase	C1Compounds	frmA
S-formylglutathione_hydrolase	C1Compounds	frmB
S-hydroxymethyl-mycothiol_dehydrogenase	C1Compounds	E1.1.1.306
formate_dehydrogenase_alpha_subunit	C1Compounds	fdh.NADP+A
formate_dehydrogenase_beta_subunit	C1Compounds	fdh.NADP+B
formate_dehydrogenase_gamma_subunit	C1Compounds	fdoI
NDMA-dependent_methanol_dehydrogenase	C1Compounds	mdo
pqq	C1Compounds	pqqC
madA	C1Compounds	mauA
madB	C1Compounds	mauB
rubisco_form_I	CarbonFixation	rbcS;rbcL
rubisco_form_II	CarbonFixation	rbcS;rbcL
rubisco_form_II-III	CarbonFixation	rbcS;rbcL
rubisco_form_III	CarbonFixation	rbcS;rbcL
aclA	CarbonFixation	aclA
aclB	CarbonFixation	aclB
codh_catalytic	CarbonFixation	cooS
codhC_beta	CarbonFixation	cdhC
codhD_delta	CarbonFixation	acsD
coxL	CarbonMonoxide	coxL
coxM	CarbonMonoxide	coxM
coxS	CarbonMonoxide	coxS
Chlorite_dismutase	HalogenatedCompounds	cld
Haloacid_dehydrogenase	HalogenatedCompounds	E3.8.1.2
Reductive_dehalogenase	HalogenatedCompounds	pceA
pcrA	HalogenatedCompounds	-
pcrB	HalogenatedCompounds	-
Hydrogenase_Group_A	Hydrogen	hydrogenase_FeFeGroupA1;hydrogenase_FeFeGroupA2;hydrogenase_FeFeGroupA3;hydrogenase_FeFeGroupA4
Hydrogenase_Group_B1-B3	Hydrogen	hydrogenase_FeFeGroupB
Hydrogenase_Group_1	Hydrogen	hydrogenase_NiFeGroup1a;hydrogenase_NiFeGroup1b;hydrogenase_NiFeGroup1c;hydrogenase_NiFeGroup1d;hydrogenase_NiFeGroup1e;hydrogenase_NiFeGroup1f;hydrogenase_NiFeGroup1g;hydrogenase_NiFeGroup1h;hydrogenase_NiFeGroup1i;hydrogenase_NiFeGroup1j;hydrogenase_NiFeGroup1k;
Hydrogenase_Group_2a	Hydrogen	hydrogenase_NiFeGroup2a
Hydrogenase_Group_2b	Hydrogen	hydrogenase_NiFeGroup2b
Hydrogenase_Group_3a	Hydrogen	hydrogenase_NiFeGroup3a
Hydrogenase_Group_3b	Hydrogen	hydrogenase_NiFeGroup3b
Hydrogenase_Group_3c	Hydrogen	hydrogenase_NiFeGroup3c
Hydrogenase_Group_3d	Hydrogen	hydrogenase_NiFeGroup3d
Hydrogenase_Group_4	Hydrogen	hydrogenase_NiFeGroup4a;hydrogenase_NiFeGroup4b;hydrogenase_NiFeGroup4c;hydrogenase_NiFeGroup4d;hydrogenase_NiFeGroup4e;hydrogenase_NiFeGroup4f;hydrogenase_NiFeGroup4g;hydrogenase_NiFeGroup4h;hydrogenase_NiFeGroup4i
mtrA	Metals	mtrA
mtrC	Metals	mtrC
pmoA	Methane	pmoA-amoA
pmoB	Methane	pmoB-amoB
pmoC	Methane	pmoC-amoC
mmoB	Methane	mmoB
mmoD	Methane	mmoD
mcrA	Methane	mcrA
mcrB	Methane	mcrB
mcrG	Methane	mcrG
nthA	Nitrile	nthA
nthB	Nitrile	nthB
amoA	Nitrogen	pmoA-amoA
amoB	Nitrogen	pmoB-amoB
amoC	Nitrogen	pmoC-amoC
hzoA	Nitrogen	hdh
hzsA	Nitrogen	hzsA
Fe_only_alpha	Nitrogen	nifD
Fe_only_beta	Nitrogen	nifK
Fe_only_delta	Nitrogen	anfG
Mo-Fe_type_Alpha	Nitrogen	nifD
Mo-Fe_type_beta	Nitrogen	nifK
nifH	Nitrogen	nifH
Vanadium-type_alpha	Nitrogen	vnfD
Vanadium-type_beta	Nitrogen	vnfK
Vanadium-type_delta	Nitrogen	vnfG
napA	Nitrogen	napA
napB	Nitrogen	napB
narG	Nitrogen	narG
norB	Nitrogen	norB
norC	Nitrogen	norC
nxrA	Nitrogen	narG
nxrB	Nitrogen	narH
cyt_c552_large_NrFA	Nitrogen	nrfA
cyt_c552_small_NrfH	Nitrogen	nrfH
nirB	Nitrogen	nirB
nirD	Nitrogen	nirD
nirK	Nitrogen	nirK
nirS	Nitrogen	nirS
nrfD	Nitrogen	nrfD
nosD	Nitrogen	nosD
nosZ	Nitrogen	nosZ
octR	Nitrogen	octR
qoxA	Oxygen	qoxA
qoxB	Oxygen	qoxB
cydA	Oxygen	cydA
cydB	Oxygen	cydB
cyoA	Oxygen	cyoA
cyoD	Oxygen	cyoD
cyoE	Oxygen	cyoE
coxA	Oxygen	coxA
coxB	Oxygen	coxB
ccoN	Oxygen	ccoN
ccoO	Oxygen	ccoO
ccoP	Oxygen	ccoP
molybdenum-binding_subunit	Selenium	xdhD
ygfK	Selenium	ygfK
ygfM	Selenium	ygfM
aprA	Sulfur	aprA
asrA	Sulfur	asrA
asrB	Sulfur	asrB
asrC	Sulfur	asrC
cysC	Sulfur	cysC
cysN	Sulfur	cysN
sat	Sulfur	sat
fcc	Sulfur	fccB
sqr	Sulfur	sqr
dsrD	Sulfur	dsrD
dsrA	Sulfur	dsrA
dsrB	Sulfur	dsrB
sor	Sulfur	sor
sulfur_dioxygenase	Sulfur	sdo
phsA	Sulfur	phsA
soxB	Sulfur	soxB
soxC	Sulfur	soxC
soxY	Sulfur	soxY
ureA	Urea	ureA
ureB	Urea	ureB
ureC	Urea	ureC